WWWWWWWWWWWWWWWWWWWWWWWWWWWWWWWWWWWWWWWWWWWWWWWWWW
WFFFFFFFFFFFFFFFFFFFFFFFFFFFFWNWFFFFFFFFFFFFFWNNNW
WFFFFFFFFFFFFFFFFFFFFFFFFFFFFWNWFFFFFFFFFFFFFWNNNW
WFFFFFFFFFFFFFFFFFFFFFFFFFFFFWNWFFFFFFFFFFFFFWNNNW
WFFFFFFFFFFFFFFFFFFFFFFFFFFFFWNWFFFFFFFFFFFFFWNNNW
WFFFFFFFFFFFFFFFFFFFFFFFFFFFFWNWFFFFFFFFFFFFFWNNNW
WFFFFFFFFFFFFFFFFFFFFFFFFFFFFWNWFFFFFFFFFFFFFWNNNW
WFFFFFFFFFFFFFFFFFFFFFFFFFFFFWNWFFFFFFFFFFFFFWNNNW
WFFFFFFFFFFFFFFFFFFFFFFFFFFFFWNWFFFFFFFFFFFFFWNNNW
WFFFFFFFFFFFFFFFFFFFFFFFFFFFFWNWFFFFFFFFFFFFFWNNNW
WFFFFFFFFFFFFFFFFFFFFFFFFFFFFWNWFFFFFFFFFFFFFWNNNW
WFFFFFFFFFFFFFFFFFFFFFFFFFFFFWNWFFFFFFFFFFFFFWNNNW
WFFFFFFFFFFFFFFFFFFFFFFFFFFFFWNWFFFFFFFFFFFFFWNNNW
WFFFFFFFFFFFFFFFFFFFFFFFFFFFFWNWFFFFFFFFFFFFFWNNNW
WFFFFFFFFFFFFFFFFFFFFFFFFFFFFWNWFFFFFFFFFFFFFWNNNW
WFFFFFFFFFFFFFFFFFFFFFFFFFFFFWNWFFFFFFFFFFFFFWNNNW
WFFFFFFFFFFFFFFFFFFFFFFFFFFFFWNWFFFFFFFDFFFFFWNNNW
WFFFFFFFFFFFFFFFFFFFFFFFWFFFFWNWFFFFFWWWWWFFFWNNNW
WFFFFFFFFFFFFFFWWWFFFFFWWFFFFWNWFFFFFFFFFFFFFWNNNW
WFFFFFFFFFFFFFFFFFFFFFFFWFFFFWNNWWWFFFFFFFFFFWNNNW
WFFFFFFFFFFFFFFFFFWFFFFFWFFFFWNWFFFFFFFFFFWWWNNNNW
WFFFFFFFFFFFFFFFFFFFWWWWWFFFFWNWFFFFFWWWFFFWWNNNNW
WFFFFFFFFFFFFFFFWWWFFFFFWFFFFWWWFFFFFFFFFFFFFWNNNW
WFFFFFFFFFFFFFFFFFFFFFFFWFFFFNNNWWWFFFFFFFFFFWNNNW
WFFFFFFFFFFFCFFFFFFFFWWWWFFFFFFFFFFFFFFFFFFFFWNNNW
WFFFFFFFFFFWWWWWWWWWWWNNWFFFFFFFFFFWWWWWWFFFFWNNNW
WFFFFFFFFFFWNNNNNNNNNNNNWFFWWWWWFFFFFFFFFFFFFWNNNW
WFFFFFFFWWWNNNNNNNNNNNNNWFFWNNNWFFFFFFFFFFWWWNNNNW
WFFFFFFFWNNNNNNNNNNNNNNNWFFWNNNWFCFFFFFFFFFFWNNNNW
WWWWWWWWNNNNNNNNNNNNNNNNWWWWNNNWWWWWWWWWWWWWWNNNNW
WNNNNNNNNNNNNNNNNNNNNNNNNNNNNNNNNNNNNNNNNNNNNNNNNW
WWWWWWWWWWWWWWWWWWWWWWWWWWWWWWWWWWWWWWWWWWWWWWWWWW