WWWWWWWWWWWWWWWWWWWWWWWWWWWWWWWWWWWWWWWWWWWWWWWWWW
WFFFFFFFFFFFFFFFFFFFFFFFFFFFFFFFFFFFFFFFFFFFFFFFFW
WFFFFFFFFFFFFFFFFFFFFFFFFFFFFFFFFFFFFFFFFFFFFFFFFW
WFFFFFFFFFFFFFFFFFFFFFFFFFFFFFFFFFFFFFFFFFFFFFFFFW
WFFFFFFFFFFFFFFFFFFFFFFFFFFFFFFFFFFFFFFFFFFFFFFFFW
WFFFFFFFFFFFFFFFFFFFFFFFFFFFFFFFFFFFFFFFFFFFFFFFFW
WFFFFFFFFFFFFFFFFFFFFFFFFFFFFFFFFFFFFFFFFFFFFFFFFW
WFFFFFFFFFFFFFFFFFFFFFFFFFFFFFFFFFFFFFFFFFFFFFFFFW
WFFFFFFFFFFFFFFFFFFFFFFFFFFFFFFFFFFFFFFFFFFFFFFFFW
WFFFFFFFFFFFFFFFFFFFFFFFFFFFFFFFFFFFFFFFFFFFFFFFFW
WFFFFFFFFFFFFFWWWFFFFFFFFFFFFFFFFFFFFFFFFFFFFFFFFW
WFFFFFFFFFFFFFFFFFFFFFFFFFFFFFFFFFFCFFFFFFFFFFFFFW
WFFFFFFFWWWWWFFFFFWWWWWWWWWWWWWWFFWWWWFFFFFFFFFFFW
WFFFFFFFFFFFFFFFFFWNNNNNNNNNNNNWFFFFFFFFFFFFFFFFFW
WFFFFFFFFFFFFFFFFFWNNNNNNNNNNNNWFFFFFFFFFFFFFFFFFW
WFFFFFFFFFFFFFFFFFWNNNNNNNNNNNNWFFFFFFFWWWFFFFFFFW
WFFFWWWWFFFWWWWFFFWNNNNNNNNNNNNWFFFFFFFFFFFFFFFFFW
WFFFFFFFFFFFFFFFFFWNNNNNNNNNNNNWFFFFFFFFFFFFFFFFFW
WFFFFFFFFFFFFFFFFFWNNNNNNNNNNNNNWFFFFFFFFWWWWWWWWW
WFFFFFFFFFFFFFFFFWWNNNNNNNNNNNNNWWFFFFFFFWFFFFFFFW
WWWFFFFFFFFFFFFFFWNNNNNNNNNNNNNNNWFFFFFFFWFFFFFFFW
WNNWWFFFFFFWWWWWWNNNNNNNNNNNNNNNNWFFFFFFFWFFFFFFFW
WNNNNWWWFFFWNNWNWNNNNNNNNNNNNNNNNWFFFFFFFWFFFFFFFW
WNNNNNNWFFFWNNWNWNNNNNNNNNNNNNNNNWFFFFFFFWFFFFFFFW
WNNNNNNWFFFWNNWNWNNNNNNNNNNNNNNNNWFFFFFFFWFFFFFFFW
WNNNNNNWFFFWNNWNWNNNNNNNNNNNNNNNNWFFFLFFFWFFFDFFFW
WNNNNNNWWWWWNNWNWNNNNNNNNNNNNNNNNWWWWWWWWWWWWWWWWW
WNNNNNNWWWWWNNNWWWNNNNNNNNNNNNNNNWWWWWWWWWWWWWWWWW
WNNNNNNNNNNNNNNNNNNNNNNNNNNNNNNNNNNNNNNNNNNNNNNNNW
WNNNNNNNNNNNNNNNNNNNNNNNNNNNNNNNNNNNNNNNNNNNNNNNNW
WNNNNNNNNNNNNNNNNNNNNNNNNNNNNNNNNNNNNNNNNNNNNNNNNW
WWWWWWWWWWWWWWWWWWWWWWWWWWWWWWWWWWWWWWWWWWWWWWWWWW