WWWWWWWWWWWWWWWWWWWW
WFFFFFFFFFFFFFFFFFFW
WFFFFFFFFFFFFFFFFFFW
WFFFFFFFFFFFFFFFFFFW
WFFFFFFFFFFFFFFFFFFW
WFFFFFFFFFFFFFFFFFFW
WFFFFFFFFFFFFFFFFFFW
WFFFFFFFFFFFFFFFFFFW
WFFFFFFFFFFFFFFFWFFW
WFFFFFFFFFFFFFFFWFFW
WFFFFFDFFFFFFFFFWFFW
WFFFFWWWWFFFFFFFWFFW
WFFFFFFFFFFFFFFFWFFW
WFFFFFFFFFFWWWWWWFFW
WFFFFFFFFFFFFNNNWFFW
WFFFFWWWWWWWFWNNWWWW
WCFFFFFFFFFFFWNNNNNW
WWWFFFFFFFFFFWNNNNNW
WFFFFFFFFFFFWNNNNNNW
WWWWWWWWWWWWWWWWWWWW
